//MAP CONVERTED BY dmm2tgm.py THIS HEADER COMMENT PREVENTS RECONVERSION, DO NOT REMOVE
"a" = (
/turf/closed/indestructible/riveted,
/area/space)
"f" = (
/obj/effect/turf_decal/trimline/purple/filled/line{
	dir = 10
	},
/obj/structure/table,
/obj/item/inducer{
	pixel_x = -1;
	pixel_y = 2
	},
/obj/machinery/cell_charger,
/obj/item/stock_parts/cell/bluespace{
	pixel_x = 1;
	pixel_y = 7
	},
/obj/item/stock_parts/cell/bluespace{
	pixel_x = -3;
	pixel_y = 6
	},
/turf/open/floor/iron/white,
/area/space)
"j" = (
/obj/effect/turf_decal/trimline/purple/filled/line{
	dir = 9
	},
/obj/effect/decal/cleanable/oil,
/turf/open/floor/iron/white,
/area/space)
"k" = (
/obj/effect/decal/cleanable/dirt,
/turf/open/floor/iron/white/textured_large,
/area/space)
"l" = (
/obj/effect/decal/cleanable/oil/streak,
/turf/open/floor/iron/white/textured_large,
/area/space)
"q" = (
/obj/structure/guncase/wt550{
	anchored = 1
	},
/turf/open/floor/iron/white/textured_large,
/area/space)
"v" = (
/obj/structure/extinguisher_cabinet/directional/north,
/obj/effect/turf_decal/trimline/purple/filled/line{
	dir = 1
	},
/obj/effect/decal/cleanable/dirt,
/turf/open/floor/iron/white/smooth_edge,
/area/space)
"x" = (
/obj/effect/turf_decal/trimline/purple/filled/line{
	dir = 8
	},
/obj/machinery/mech_bay_recharge_port,
/turf/open/floor/iron/white/smooth_edge{
	dir = 4
	},
/area/space)
"C" = (
/obj/structure/closet,
/obj/effect/turf_decal/trimline/purple/filled/line{
	dir = 6
	},
/obj/item/clothing/under/costume/mech_suit,
/obj/item/clothing/under/costume/mech_suit,
/obj/item/clothing/under/costume/mech_suit,
/obj/item/clothing/under/costume/mech_suit,
/obj/item/ammo_box/magazine/wt550m9,
/obj/item/ammo_box/magazine/wt550m9,
/obj/item/ammo_box/magazine/wt550m9,
/obj/item/ammo_box/magazine/wt550m9,
/obj/item/ammo_box/magazine/wt550m9/wtic,
/obj/item/ammo_box/magazine/wt550m9/wtic,
/turf/open/floor/iron/white,
/area/space)
"F" = (
/obj/effect/turf_decal/trimline/purple/filled/line{
	dir = 1
	},
/obj/structure/fireaxecabinet/mechremoval/directional/north,
/turf/open/floor/iron/white/smooth_edge,
/area/space)
"G" = (
/obj/vehicle/sealed/mecha/marauder/seraph,
/turf/open/floor/iron/white/textured_large,
/area/space)
"H" = (
/obj/effect/landmark/bitrunning/hololadder_spawn,
/obj/effect/turf_decal/trimline/purple/filled/line,
/obj/effect/decal/cleanable/dirt,
/turf/open/floor/iron/white/smooth_edge{
	dir = 1
	},
/area/space)
"K" = (
/obj/structure/closet,
/obj/effect/turf_decal/trimline/purple/filled/line{
	dir = 4
	},
/obj/item/storage/toolbox/mechanical,
/obj/item/storage/toolbox/mechanical{
	pixel_y = 3
	},
/obj/item/storage/toolbox/mechanical{
	pixel_y = -3
	},
/turf/open/floor/iron/white/smooth_edge{
	dir = 8
	},
/area/space)
"M" = (
/obj/machinery/light/directional/west,
/obj/effect/turf_decal/trimline/purple/filled/line{
	dir = 8
	},
/obj/machinery/computer/mech_bay_power_console{
	dir = 4
	},
/turf/open/floor/iron/white/smooth_edge{
	dir = 4
	},
/area/space)
"N" = (
/obj/effect/turf_decal/trimline/purple/filled/line{
	dir = 1
	},
/turf/open/floor/iron/white/smooth_edge,
/area/space)
"R" = (
/obj/effect/turf_decal/trimline/purple/filled/line{
	dir = 5
	},
/obj/machinery/mechpad,
/turf/open/floor/iron/white,
/area/space)
"S" = (
/obj/effect/turf_decal/loading_area{
	dir = 4
	},
/obj/machinery/light/directional/east,
/obj/structure/railing,
/obj/effect/landmark/bitrunning/cache_goal_turf,
/obj/effect/decal/cleanable/oil/slippery,
/turf/open/floor/bitrunning_transport,
/area/space)
"T" = (
/obj/machinery/door/airlock/external/glass{
	name = "Mining External Airlock"
	},
/obj/effect/mapping_helpers/airlock/access/all,
/obj/structure/fans/tiny,
/turf/open/floor/iron/dark/textured_large,
/area/space)
"U" = (
/obj/effect/landmark/bitrunning/hololadder_spawn,
/obj/effect/turf_decal/trimline/purple/filled/line,
/turf/open/floor/iron/white/smooth_edge{
	dir = 1
	},
/area/space)
"Y" = (
/turf/closed/indestructible/fakeglass,
/area/space)

(1,1,1) = {"
a
a
a
Y
Y
a
"}
(2,1,1) = {"
Y
j
M
x
f
a
"}
(3,1,1) = {"
a
F
k
k
U
Y
"}
(4,1,1) = {"
T
N
G
q
U
Y
"}
(5,1,1) = {"
a
v
l
k
H
Y
"}
(6,1,1) = {"
Y
R
S
K
C
a
"}
(7,1,1) = {"
a
a
a
Y
Y
a
"}
