//MAP CONVERTED BY dmm2tgm.py THIS HEADER COMMENT PREVENTS RECONVERSION, DO NOT REMOVE
"a" = (
/turf/open/floor/mineral/titanium/tiled,
/area/shuttle/escape)
"f" = (
/obj/machinery/power/terminal{
	dir = 1
	},
/obj/structure/cable,
/turf/open/floor/plating,
/area/shuttle/escape)
"i" = (
/obj/structure/cable,
/obj/effect/spawner/random/maintenance/two,
/turf/open/floor/plating,
/area/shuttle/escape)
"j" = (
/obj/structure/cable,
/turf/open/floor/plating,
/area/shuttle/escape)
"k" = (
/obj/machinery/power/smes/magical{
	desc = "A high-capacity superconducting magnetic energy storage (SMES) unit.";
	name = "power storage unit"
	},
/obj/structure/cable,
/turf/open/floor/plating,
/area/shuttle/escape)
"p" = (
/obj/structure/cable,
/obj/machinery/light/small/directional/south,
/obj/structure/closet/crate,
/obj/item/clothing/head/costume/ushanka,
/obj/effect/spawner/random/maintenance/two,
/turf/open/floor/plating,
/area/shuttle/escape)
"r" = (
/obj/machinery/door/airlock/external/ruin{
	name = "Ruskie DJ Station"
	},
/obj/effect/mapping_helpers/airlock/cyclelink_helper,
/obj/modular_map_connector,
/turf/open/floor/plating,
/area/shuttle/escape)
"t" = (
/obj/structure/cable,
/obj/machinery/door/airlock/maintenance_hatch,
/turf/open/floor/plating,
/area/shuttle/escape)
"x" = (
/turf/open/floor/plating,
/area/shuttle/escape)
"B" = (
/turf/closed/wall,
/area/shuttle/escape)
"H" = (
/obj/structure/cable,
/obj/machinery/power/apc/auto_name/directional/east,
/obj/machinery/duct,
/turf/open/floor/plating,
/area/shuttle/escape)
"I" = (
/obj/structure/reagent_dispensers/plumbed{
	dir = 8
	},
/turf/open/floor/plating,
/area/shuttle/escape)
"J" = (
/obj/effect/spawner/structure/window/reinforced,
/obj/structure/cable,
/turf/open/floor/plating,
/area/shuttle/escape)
"M" = (
/obj/machinery/light/small/directional/north,
/obj/structure/closet/crate,
/obj/item/gps/spaceruin,
/obj/effect/spawner/random/maintenance/three,
/turf/open/floor/plating,
/area/shuttle/escape)
"P" = (
/obj/structure/cable,
/obj/structure/closet/crate,
/obj/effect/spawner/random/maintenance/five,
/turf/open/floor/plating,
/area/shuttle/escape)
"R" = (
/obj/effect/spawner/structure/window/reinforced,
/turf/open/floor/plating,
/area/shuttle/escape)
"W" = (
/obj/machinery/duct,
/turf/open/floor/plating,
/area/shuttle/escape)
"X" = (
/obj/structure/sign/warning/vacuum/external/directional/south,
/obj/effect/spawner/random/maintenance,
/turf/open/floor/plating,
/area/shuttle/escape)
"Y" = (
/obj/machinery/door/airlock/maintenance_hatch,
/obj/machinery/duct,
/turf/open/floor/plating,
/area/shuttle/escape)

(1,1,1) = {"
a
B
R
J
R
B
a
"}
(2,1,1) = {"
B
B
M
P
j
B
B
"}
(3,1,1) = {"
t
j
x
x
j
X
B
"}
(4,1,1) = {"
B
i
j
k
f
x
r
"}
(5,1,1) = {"
Y
H
W
x
j
x
B
"}
(6,1,1) = {"
B
B
I
j
p
B
B
"}
