//MAP CONVERTED BY dmm2tgm.py THIS HEADER COMMENT PREVENTS RECONVERSION, DO NOT REMOVE
"a" = (
/turf/open/floor/mineral/titanium/white,
/area/shuttle/escape)
"d" = (
/obj/structure/table,
/obj/item/storage/medkit/fire,
/obj/item/storage/medkit/regular{
	pixel_x = 4;
	pixel_y = 3
	},
/obj/item/storage/medkit/brute{
	pixel_x = 5;
	pixel_y = -1
	},
/turf/open/floor/mineral/titanium,
/area/shuttle/escape)
"g" = (
/obj/structure/table,
/obj/item/defibrillator/loaded,
/turf/open/floor/mineral/titanium,
/area/shuttle/escape)
"h" = (
/obj/machinery/shower/directional/west,
/turf/open/floor/mineral/titanium/white,
/area/shuttle/escape)
"j" = (
/turf/closed/wall/mineral/titanium,
/area/shuttle/escape)
"n" = (
/obj/structure/table,
/obj/item/reagent_containers/cup/bottle/epinephrine{
	pixel_x = 6
	},
/obj/item/reagent_containers/cup/bottle/multiver{
	pixel_x = -3
	},
/obj/item/reagent_containers/cup/bottle/epinephrine{
	pixel_x = -3;
	pixel_y = 8
	},
/obj/item/reagent_containers/cup/bottle/multiver{
	pixel_x = 6;
	pixel_y = 8
	},
/obj/item/reagent_containers/syringe/epinephrine{
	pixel_x = 3;
	pixel_y = -2
	},
/obj/item/reagent_containers/syringe/epinephrine{
	pixel_x = 4;
	pixel_y = 1
	},
/obj/item/reagent_containers/syringe/epinephrine{
	pixel_x = -2;
	pixel_y = 5
	},
/obj/item/reagent_containers/syringe/epinephrine{
	pixel_x = 2;
	pixel_y = 8
	},
/turf/open/floor/mineral/titanium,
/area/shuttle/escape)
"p" = (
/obj/machinery/stasis,
/obj/machinery/light/directional/north,
/turf/open/floor/mineral/titanium,
/area/shuttle/escape)
"x" = (
/obj/machinery/status_display/evac,
/turf/closed/wall/mineral/titanium/nodiagonal,
/area/shuttle/escape)
"E" = (
/obj/item/surgery_tray/full,
/obj/item/clothing/suit/apron/surgical,
/obj/item/clothing/mask/surgical,
/obj/structure/table/optable,
/obj/machinery/light/directional/north,
/turf/open/floor/mineral/titanium,
/area/shuttle/escape)
"I" = (
/obj/machinery/door/airlock/public/glass{
	name = "Emergency Shuttle Infirmary"
	},
/turf/open/floor/mineral/titanium/white,
/area/shuttle/escape)
"K" = (
/obj/effect/spawner/structure/window/reinforced/shuttle,
/turf/open/floor/plating,
/area/shuttle/escape)
"L" = (
/obj/machinery/stasis{
	dir = 4
	},
/turf/open/floor/mineral/titanium,
/area/shuttle/escape)
"P" = (
/obj/machinery/stasis,
/turf/open/floor/mineral/titanium,
/area/shuttle/escape)
"U" = (
/obj/effect/spawner/structure/window/reinforced/shuttle,
/obj/modular_map_connector,
/turf/open/floor/plating,
/area/shuttle/escape)
"X" = (
/obj/structure/sink/directional/east,
/turf/open/floor/mineral/titanium/white,
/area/shuttle/escape)
"Z" = (
/obj/structure/table,
/obj/item/storage/medkit/toxin,
/obj/item/storage/medkit/o2{
	pixel_x = 3;
	pixel_y = 3
	},
/turf/open/floor/mineral/titanium,
/area/shuttle/escape)

(1,1,1) = {"
x
K
K
j
j
K
K
j
"}
(2,1,1) = {"
j
E
a
a
a
X
n
j
"}
(3,1,1) = {"
I
a
a
a
a
a
a
j
"}
(4,1,1) = {"
K
P
a
a
a
a
d
j
"}
(5,1,1) = {"
U
L
a
a
a
a
Z
j
"}
(6,1,1) = {"
I
a
a
a
a
a
a
j
"}
(7,1,1) = {"
j
p
a
a
a
h
g
j
"}
(8,1,1) = {"
x
K
K
j
j
K
K
j
"}
