//MAP CONVERTED BY dmm2tgm.py THIS HEADER COMMENT PREVENTS RECONVERSION, DO NOT REMOVE
"a" = (
/turf/open/floor/plating,
/area/shuttle/escape)
"d" = (
/obj/structure/chair{
	dir = 1
	},
/turf/open/floor/mineral/plastitanium/red,
/area/shuttle/escape)
"h" = (
/obj/structure/chair/comfy/shuttle{
	dir = 4
	},
/turf/open/floor/mineral/plastitanium/red,
/area/shuttle/escape)
"j" = (
/obj/structure/closet/firecloset,
/turf/open/floor/plating,
/area/shuttle/escape)
"l" = (
/obj/structure/table,
/obj/item/storage/fancy/donut_box,
/obj/item/book/manual/wiki/security_space_law,
/obj/item/storage/box/handcuffs,
/turf/open/floor/mineral/plastitanium/red,
/area/shuttle/escape)
"n" = (
/obj/effect/spawner/random/trash/hobo_squat,
/turf/open/floor/mineral/plastitanium/red,
/area/shuttle/escape)
"p" = (
/turf/open/floor/mineral/plastitanium/red,
/area/shuttle/escape)
"q" = (
/obj/modular_map_connector,
/turf/closed/wall/mineral/titanium,
/area/shuttle/escape)
"s" = (
/obj/structure/chair/comfy/shuttle{
	dir = 1
	},
/turf/open/floor/mineral/plastitanium/red,
/area/shuttle/escape)
"v" = (
/obj/machinery/status_display/evac,
/turf/closed/wall/mineral/titanium/nodiagonal,
/area/shuttle/escape)
"w" = (
/turf/closed/wall/mineral/titanium/nodiagonal,
/area/shuttle/escape)
"z" = (
/obj/machinery/door/airlock/public/glass{
	name = "Containment Cell"
	},
/obj/effect/mapping_helpers/airlock/access/all/security/general,
/turf/open/floor/mineral/plastitanium/red,
/area/shuttle/escape)
"B" = (
/obj/structure/closet/emcloset,
/turf/open/floor/plating,
/area/shuttle/escape)
"C" = (
/obj/machinery/door/airlock/public/glass{
	name = "Emergency Shuttle Brig"
	},
/obj/effect/mapping_helpers/airlock/access/all/security/general,
/turf/open/floor/plating,
/area/shuttle/escape)
"D" = (
/obj/item/chair,
/turf/open/floor/mineral/plastitanium/red,
/area/shuttle/escape)
"E" = (
/obj/structure/table,
/obj/machinery/recharger,
/obj/structure/reagent_dispensers/wall/peppertank/directional/north,
/obj/machinery/light/directional/west,
/turf/open/floor/mineral/plastitanium/red,
/area/shuttle/escape)
"F" = (
/obj/effect/spawner/structure/window/reinforced/shuttle,
/turf/open/floor/plating,
/area/shuttle/escape)
"T" = (
/obj/structure/chair/stool/directional/south,
/turf/open/floor/plating,
/area/shuttle/escape)
"U" = (
/obj/machinery/light/directional/west,
/turf/open/floor/mineral/plastitanium/red,
/area/shuttle/escape)
"Z" = (
/turf/closed/wall/mineral/titanium,
/area/shuttle/escape)

(1,1,1) = {"
p
h
h
h
w
E
h
w
"}
(2,1,1) = {"
p
p
p
p
p
p
p
s
"}
(3,1,1) = {"
p
p
p
p
p
p
p
s
"}
(4,1,1) = {"
p
p
p
p
p
p
p
s
"}
(5,1,1) = {"
q
w
z
w
l
p
p
s
"}
(6,1,1) = {"
n
U
d
Z
F
C
F
v
"}
(7,1,1) = {"
D
p
d
Z
j
a
a
B
"}
(8,1,1) = {"
p
p
d
Z
T
a
a
a
"}
