//MAP CONVERTED BY dmm2tgm.py THIS HEADER COMMENT PREVENTS RECONVERSION, DO NOT REMOVE
"a" = (
/turf/open/misc/asteroid/snow/icemoon/do_not_chasm,
/area/icemoon/surface/outdoors/nospawn)
"g" = (
/obj/structure/flora/rock/pile/style_random,
/turf/open/misc/asteroid/snow/icemoon/do_not_chasm,
/area/icemoon/surface/outdoors/nospawn)
"i" = (
/obj/structure/excalibur_mount,
/turf/open/misc/asteroid/snow/icemoon/do_not_chasm,
/area/icemoon/surface/outdoors/nospawn)
"s" = (
/obj/structure/flora/tree/pine/style_random,
/turf/open/misc/asteroid/snow/icemoon/do_not_chasm,
/area/icemoon/surface/outdoors/nospawn)

(1,1,1) = {"
a
a
a
a
a
a
a
a
a
"}
(2,1,1) = {"
a
a
s
a
a
a
a
a
a
"}
(3,1,1) = {"
a
a
a
a
a
a
a
s
a
"}
(4,1,1) = {"
a
s
a
g
a
g
a
a
a
"}
(5,1,1) = {"
a
a
a
a
i
a
a
a
a
"}
(6,1,1) = {"
a
a
a
a
g
a
a
a
a
"}
(7,1,1) = {"
a
a
a
a
a
a
a
a
a
"}
(8,1,1) = {"
a
a
a
s
a
a
a
a
a
"}
(9,1,1) = {"
a
a
a
a
a
a
a
a
a
"}
