"a" = (/turf/template_noop,/area/template_noop)
"d" = (/obj/machinery/power/shuttle_engine/propulsion,/turf/open/floor/plating/airless,/area/shuttle/escape/engine)
"g" = (/obj/machinery/door/airlock/shuttle,/turf/open/floor/plating,/area/shuttle/escape)
"k" = (/obj/effect/spawner/structure/window/reinforced/shuttle,/turf/open/floor/plating,/area/shuttle/escape)
"n" = (/turf/closed/wall/mineral/plastitanium,/area/shuttle/escape/engine)
"o" = (/obj/structure/table,/obj/machinery/recharger,/turf/open/floor/mineral/titanium/blue,/area/shuttle/escape)
"p" = (/obj/effect/mapping_helpers/airlock/access/all/engineering,/obj/machinery/door/airlock/engineering/glass,/turf/open/floor/plating,/area/shuttle/escape/engine)
"s" = (/turf/open/floor/engine/air,/area/shuttle/escape/engine)
"t" = (/turf/open/floor/plating,/area/shuttle/escape)
"w" = (/obj/effect/spawner/structure/window/reinforced/shuttle,/turf/open/floor/plating,/area/shuttle/escape/engine)
"y" = (/obj/machinery/computer/emergency_shuttle,/turf/open/floor/mineral/titanium/blue,/area/shuttle/escape)
"z" = (/turf/open/floor/pod,/area/shuttle/escape)
"B" = (/obj/structure/tramwall/plastitanium,/turf/open/floor/plating,/area/shuttle/escape/engine)
"D" = (/obj/machinery/computer/communications,/turf/open/floor/mineral/titanium/blue,/area/shuttle/escape)
"E" = (/obj/structure/chair/stool/directional/west,/turf/open/floor/pod,/area/shuttle/escape)
"G" = (/obj/effect/spawner/structure/window/reinforced/shuttle,/obj/machinery/power/shuttle_engine/heater,/turf/open/floor/mineral/titanium/yellow,/area/shuttle/escape/engine)
"L" = (/turf/open/floor/mineral/titanium/yellow,/area/shuttle/escape/engine)
"N" = (/obj/machinery/door/airlock/engineering/glass,/obj/effect/mapping_helpers/airlock/access/all/engineering,/turf/open/floor/plating,/area/shuttle/escape/engine)
"O" = (/turf/open/floor/mineral/titanium/blue,/area/shuttle/escape)
"R" = (/turf/open/floor/pod/light,/area/shuttle/escape)
"S" = (/obj/structure/chair/stool/directional/east,/turf/open/floor/pod,/area/shuttle/escape)
"V" = (/obj/machinery/door/airlock/shuttle,/obj/docking_port/mobile/emergency/shuttle_build{dwidth = 2; height = 30; name = "Welding Fuel Shuttle"; width = 9},/turf/open/floor/plating,/area/shuttle/escape)
"X" = (/turf/closed/wall/mineral/plastitanium,/area/shuttle/escape)
"Y" = (/obj/effect/mapping_helpers/airlock/access/all/command,/obj/machinery/door/airlock/command/glass,/turf/open/floor/plating,/area/shuttle/escape)

(1,1,1) = {"
aXkkkkkXa
akOyODOka
akOOOOOka
XXOOOOOXX
XoOOOOOoX
XXXYXYXXX
XSzzzzzEX
kzRRRRREX
XSRzzzRzk
gzREtSRzk
XSREtSRzk
VzREtSREX
XSREtSRzk
kzREtSRzk
kzRzzzRzk
kzREtSRzk
XSREtSREt
gzREtSRzk
XSREtSRzk
gzREtSRzk
XSRzzzREX
XSzzzzzEX
nnnNnpnnn
wLLLLLLLw
wLLsssLLw
wLLsssLLw
nLLsssLLn
nnLLLLLnn
anGGGGGna
aBdddddBa
"}
