//MAP CONVERTED BY dmm2tgm.py THIS HEADER COMMENT PREVENTS RECONVERSION, DO NOT REMOVE
"a" = (
/turf/template_noop,
/area/template_noop)
"c" = (
/turf/closed/wall/mineral/titanium/nodiagonal,
/area/shuttle/escape)
"e" = (
/turf/closed/wall/mineral/plastitanium,
/area/shuttle/escape)
"j" = (
/obj/machinery/door/airlock/titanium{
	name = "Emergency Shuttle Airlock"
	},
/obj/docking_port/mobile/emergency{
	port_direction = 4;
	preferred_direction = 2;
	name = "Kerfuffle-Shuttle"
	},
/turf/open/floor/plating,
/area/shuttle/escape)
"n" = (
/turf/open/floor/iron/white,
/area/shuttle/escape)
"w" = (
/turf/open/floor/iron/dark,
/area/shuttle/escape)
"y" = (
/obj/modular_map_root/modular_shuttle{
	key = "generic_shuttlemod"
	},
/turf/open/floor/plating,
/area/shuttle/escape)
"A" = (
/obj/structure/window/reinforced/spawner/directional/south,
/obj/machinery/power/shuttle_engine/heater{
	dir = 1
	},
/obj/effect/turf_decal/stripes/line{
	dir = 1
	},
/turf/open/floor/plating/airless,
/area/shuttle/escape)
"B" = (
/obj/machinery/power/shuttle_engine/propulsion{
	dir = 1
	},
/obj/effect/turf_decal/stripes/line{
	dir = 1
	},
/turf/open/floor/plating/airless,
/area/shuttle/escape)
"H" = (
/turf/open/space/basic,
/area/shuttle/escape)
"I" = (
/turf/open/floor/plating,
/area/shuttle/escape)
"J" = (
/turf/open/floor/pod/light,
/area/shuttle/escape)
"M" = (
/turf/open/space/basic,
/area/template_noop)
"V" = (
/obj/modular_map_root/modular_shuttle/bridge,
/turf/open/space/basic,
/area/shuttle/escape)
"W" = (
/turf/open/floor/pod,
/area/shuttle/escape)
"X" = (
/obj/machinery/door/airlock/titanium{
	name = "Emergency Shuttle Airlock"
	},
/turf/open/floor/plating,
/area/shuttle/escape)

(1,1,1) = {"
a
H
H
H
H
H
H
H
H
H
X
c
j
H
H
H
H
H
H
H
H
H
a
a
a
a
a
a
"}
(2,1,1) = {"
B
A
I
I
I
I
I
I
I
I
w
w
w
I
I
I
I
I
I
I
I
H
a
a
a
a
a
a
"}
(3,1,1) = {"
B
A
I
I
I
I
I
I
I
I
w
w
w
I
I
I
I
I
I
I
I
H
a
a
a
a
a
a
"}
(4,1,1) = {"
e
e
I
I
I
I
I
I
I
I
w
w
w
I
I
I
I
I
I
I
I
H
H
H
H
H
H
H
"}
(5,1,1) = {"
B
A
y
I
I
I
I
I
I
I
w
w
w
y
I
I
I
I
I
I
I
H
H
H
H
H
H
H
"}
(6,1,1) = {"
B
A
I
I
I
I
I
I
I
I
w
w
w
I
I
I
I
I
I
I
I
H
H
H
H
H
H
H
"}
(7,1,1) = {"
B
A
I
I
I
I
I
I
I
I
w
J
w
I
I
I
I
I
I
I
I
H
H
H
H
H
H
H
"}
(8,1,1) = {"
e
e
I
I
I
I
I
I
I
I
W
W
W
I
I
I
I
I
I
I
I
H
H
H
H
H
H
H
"}
(9,1,1) = {"
B
A
n
n
n
n
n
n
n
J
W
J
W
J
n
n
n
n
n
n
n
V
H
H
H
H
H
H
"}
(10,1,1) = {"
e
e
I
I
I
I
I
I
I
I
W
W
W
I
I
I
I
I
I
I
I
H
H
H
H
H
H
H
"}
(11,1,1) = {"
B
A
I
I
I
I
I
I
I
I
w
J
w
I
I
I
I
I
I
I
I
H
H
H
H
H
H
H
"}
(12,1,1) = {"
B
A
I
I
I
I
I
I
I
I
w
w
w
I
I
I
I
I
I
I
I
H
H
H
H
H
H
H
"}
(13,1,1) = {"
B
A
I
I
I
I
I
I
I
I
w
w
w
I
I
I
I
I
I
I
I
H
H
H
H
H
H
H
"}
(14,1,1) = {"
e
e
y
I
I
I
I
I
I
I
w
w
w
y
I
I
I
I
I
I
I
H
H
H
H
H
H
H
"}
(15,1,1) = {"
B
A
I
I
I
I
I
I
I
I
w
w
w
I
I
I
I
I
I
I
I
H
M
M
M
M
M
M
"}
(16,1,1) = {"
B
A
I
I
I
I
I
I
I
I
w
w
w
I
I
I
I
I
I
I
I
H
a
a
a
a
a
a
"}
(17,1,1) = {"
a
H
H
H
H
H
H
H
H
H
X
c
X
H
H
H
H
H
H
H
H
H
a
a
a
a
a
a
"}
