"a" = (/turf/template_noop,/area/template_noop)
"d" = (/obj/machinery/power/shuttle_engine/propulsion,/turf/open/floor/plating/airless,/area/shuttle/escape/engine)
"g" = (/obj/machinery/door/airlock/shuttle,/turf/open/space/basic,/area/shuttle/escape)
"h" = (/obj/structure/tramwall/plastitanium,/turf/open/space/basic,/area/shuttle/escape/engine)
"k" = (/obj/effect/spawner/structure/window/reinforced/shuttle,/turf/open/floor/plating,/area/shuttle/escape)
"n" = (/obj/structure/tramwall/plastitanium,/obj/structure/tramwall/plastitanium,/turf/open/space/basic,/area/shuttle/escape/engine)
"o" = (/obj/structure/table,/obj/machinery/recharger,/turf/open/floor/mineral/titanium/blue,/area/shuttle/escape)
"p" = (/obj/effect/mapping_helpers/airlock/access/all/engineering,/obj/machinery/door/airlock/engineering/glass,/turf/open/floor/plating,/area/shuttle/escape/engine)
"s" = (/turf/open/floor/engine/air,/area/shuttle/escape/engine)
"t" = (/obj/effect/spawner/structure/window/reinforced/shuttle,/turf/open/floor/plating,/area/shuttle/escape/engine)
"w" = (/obj/effect/spawner/structure/window/reinforced/shuttle,/turf/open/space/basic,/area/shuttle/escape)
"y" = (/obj/machinery/computer/emergency_shuttle,/turf/open/floor/mineral/titanium/blue,/area/shuttle/escape)
"z" = (/turf/open/floor/pod,/area/shuttle/escape)
"B" = (/obj/structure/tramwall/plastitanium,/turf/open/floor/plating,/area/shuttle/escape/engine)
"C" = (/obj/structure/tramwall/plastitanium,/turf/open/floor/mineral/titanium/blue,/area/shuttle/escape)
"D" = (/obj/machinery/computer/communications,/turf/open/floor/mineral/titanium/blue,/area/shuttle/escape)
"E" = (/obj/structure/chair/stool/directional/west,/turf/open/floor/pod,/area/shuttle/escape)
"G" = (/obj/effect/spawner/structure/window/reinforced/shuttle,/obj/machinery/power/shuttle_engine/heater,/turf/open/floor/mineral/titanium/yellow,/area/shuttle/escape/engine)
"K" = (/obj/structure/tramwall/plastitanium,/turf/open/space/basic,/area/shuttle/escape)
"L" = (/turf/open/floor/mineral/titanium/yellow,/area/shuttle/escape/engine)
"N" = (/obj/machinery/door/airlock/engineering/glass,/obj/effect/mapping_helpers/airlock/access/all/engineering,/turf/open/floor/plating,/area/shuttle/escape/engine)
"O" = (/turf/open/floor/mineral/titanium/blue,/area/shuttle/escape)
"R" = (/turf/open/floor/pod/light,/area/shuttle/escape)
"S" = (/obj/structure/chair/stool/directional/east,/turf/open/floor/pod,/area/shuttle/escape)
"V" = (/obj/machinery/door/airlock/shuttle,/obj/docking_port/mobile/emergency/shuttle_build{height = 30; name = "Welding Fuel Shuttle"; width = 9},/turf/open/space/basic,/area/shuttle/escape)
"X" = (/obj/structure/tramwall/plastitanium,/turf/open/floor/plating,/area/shuttle/escape)
"Y" = (/obj/effect/mapping_helpers/airlock/access/all/command,/obj/machinery/door/airlock/command/glass,/turf/open/floor/plating,/area/shuttle/escape)

(1,1,1) = {"
aKkkkkkKa
akOyODOka
awOOOOOwa
KCOOOOOCK
KoOOOOOoK
KKKYKYKKK
KSzzzzzEK
kzRRRRREX
XSRzzzRzk
gzREKSRzk
KSREKSRzk
VzREKSREX
KSREKSRzk
kzREKSRzk
kzRzzzRzk
kzREKSRzk
KSREKSREK
gzREKSRzk
KSREKSRzk
gzREKSRzk
KSRzzzREK
KSzzzzzEK
hhhNhphhh
tLLLLLLLt
tLLsssLLt
tLLsssLLt
BLLsssLLB
hhLLLLLhh
ahGGGGGna
ahdddddha
"}
