//MAP CONVERTED BY dmm2tgm.py THIS HEADER COMMENT PREVENTS RECONVERSION, DO NOT REMOVE
"a" = (
/turf/template_noop,
/area/template_noop)
"c" = (
/turf/closed/wall/mineral/titanium/nodiagonal,
/area/shuttle/escape)
"e" = (
/turf/closed/wall/mineral/plastitanium,
/area/shuttle/escape)
"g" = (
/turf/open/floor/pod/light,
/area/shuttle/escape)
"j" = (
/obj/machinery/door/airlock/titanium{
	name = "Emergency Shuttle Airlock"
	},
/obj/docking_port/mobile/emergency{
	port_direction = 4;
	preferred_direction = 2;
	name = "Kerfuffle-Shuttle"
	},
/turf/open/floor/plating,
/area/shuttle/escape)
"l" = (
/obj/modular_map_root/modular_shuttle/bridge{
	key = "bridge"
	},
/turf/closed/wall/mineral/titanium/nodiagonal,
/area/shuttle/escape)
"n" = (
/turf/open/floor/iron/white,
/area/shuttle/escape)
"w" = (
/turf/open/floor/iron/dark,
/area/shuttle/escape)
"y" = (
/obj/modular_map_root/modular_shuttle{
	key = "generic_shuttlemod"
	},
/turf/open/floor/plating,
/area/shuttle/escape)
"A" = (
/obj/structure/window/reinforced/spawner/directional/south,
/obj/machinery/power/shuttle_engine/heater{
	dir = 1
	},
/obj/effect/turf_decal/stripes/line{
	dir = 1
	},
/turf/open/floor/plating/airless,
/area/shuttle/escape)
"B" = (
/obj/machinery/power/shuttle_engine/propulsion{
	dir = 1
	},
/obj/effect/turf_decal/stripes/line{
	dir = 1
	},
/turf/open/floor/plating/airless,
/area/shuttle/escape)
"H" = (
/turf/closed/wall/mineral/titanium,
/area/shuttle/escape)
"I" = (
/turf/open/floor/plating,
/area/shuttle/escape)
"J" = (
/obj/effect/spawner/structure/window/reinforced/shuttle,
/turf/open/floor/plating,
/area/shuttle/escape)
"M" = (
/turf/open/floor/pod,
/area/shuttle/escape)
"W" = (
/obj/machinery/computer/emergency_shuttle{
	dir = 1
	},
/turf/open/floor/plating,
/area/shuttle/escape)
"X" = (
/obj/machinery/door/airlock/titanium{
	name = "Emergency Shuttle Airlock"
	},
/turf/open/floor/plating,
/area/shuttle/escape)

(1,1,1) = {"
a
c
c
J
J
J
J
J
J
c
X
c
j
c
J
J
J
J
J
J
c
H
a
a
a
a
a
a
"}
(2,1,1) = {"
B
A
I
I
I
I
I
I
I
I
w
w
w
I
I
I
I
I
I
I
I
c
a
a
a
a
a
a
"}
(3,1,1) = {"
B
A
I
I
I
I
I
I
I
I
w
w
w
I
I
I
I
I
I
I
I
c
a
a
a
a
a
a
"}
(4,1,1) = {"
e
e
I
I
I
I
I
I
I
I
w
w
w
I
I
I
I
I
I
I
I
c
c
c
J
J
J
J
"}
(5,1,1) = {"
B
A
y
I
I
I
I
I
I
I
w
w
w
y
I
I
I
I
I
I
I
c
I
I
I
I
I
J
"}
(6,1,1) = {"
B
A
I
I
I
I
I
I
I
I
w
w
w
I
I
I
I
I
I
I
I
c
I
I
I
I
I
J
"}
(7,1,1) = {"
B
A
I
I
I
I
I
I
I
I
w
g
w
I
I
I
I
I
I
I
I
c
I
I
I
I
I
J
"}
(8,1,1) = {"
e
e
I
I
I
I
I
I
I
I
M
M
M
I
I
I
I
I
I
I
I
I
I
I
I
I
I
J
"}
(9,1,1) = {"
B
A
n
n
n
n
n
n
n
g
M
g
M
g
n
n
n
n
n
n
n
l
I
I
I
I
W
J
"}
(10,1,1) = {"
e
e
I
I
I
I
I
I
I
I
M
M
M
I
I
I
I
I
I
I
I
I
I
I
I
I
I
J
"}
(11,1,1) = {"
B
A
I
I
I
I
I
I
I
I
w
g
w
I
I
I
I
I
I
I
I
c
I
I
I
I
I
J
"}
(12,1,1) = {"
B
A
I
I
I
I
I
I
I
I
w
w
w
I
I
I
I
I
I
I
I
c
I
I
I
I
I
J
"}
(13,1,1) = {"
B
A
I
I
I
I
I
I
I
I
w
w
w
I
I
I
I
I
I
I
I
c
I
I
I
I
I
J
"}
(14,1,1) = {"
e
e
y
I
I
I
I
I
I
I
w
w
w
y
I
I
I
I
I
I
I
c
c
c
J
J
J
J
"}
(15,1,1) = {"
B
A
I
I
I
I
I
I
I
I
w
w
w
I
I
I
I
I
I
I
I
c
a
a
a
a
a
a
"}
(16,1,1) = {"
B
A
I
I
I
I
I
I
I
I
w
w
w
I
I
I
I
I
I
I
I
c
a
a
a
a
a
a
"}
(17,1,1) = {"
a
c
c
c
J
c
c
c
c
c
J
c
c
c
J
c
c
c
J
c
c
H
a
a
a
a
a
a
"}
