"a" = (/turf/template_noop,/area/template_noop)
"b" = (/obj/structure/table,/obj/machinery/recharger{active_power_usage = 0; idle_power_usage = 0; use_power = 0},/turf/open/floor/mineral/plastitanium/red/brig,/area/space)
"c" = (/obj/effect/spawner/structure/window/reinforced/shuttle,/turf/open/floor/plating,/area/space)
"d" = (/obj/machinery/power/shuttle_engine/propulsion,/turf/open/floor/plating/airless,/area/shuttle/escape/engine)
"e" = (/obj/item/storage/medkit/fire,/obj/structure/table,/turf/open/floor/mineral/titanium/white,/area/space)
"f" = (/obj/effect/spawner/structure/window/reinforced/shuttle,/turf/open/floor/plating,/area/shuttle/escape/engine)
"g" = (/obj/machinery/door/airlock/shuttle,/turf/open/floor/plating,/area/shuttle/escape)
"i" = (/obj/machinery/door/airlock/security/glass{name = "Escape Shuttle Brig"},/obj/effect/mapping_helpers/airlock/access/all/security/general,/turf/open/floor/plating,/area/shuttle/escape)
"j" = (/obj/machinery/fuel_extractor,/turf/open/floor/engine/air,/area/shuttle/escape/engine)
"k" = (/obj/effect/spawner/structure/window/reinforced/shuttle,/turf/open/floor/plating,/area/shuttle/escape)
"l" = (/obj/structure/tank_holder/extinguisher,/turf/open/floor/mineral/titanium/yellow,/area/shuttle/escape/engine)
"m" = (/obj/effect/mapping_helpers/airlock/access/all/command,/obj/machinery/door/airlock/command/glass,/turf/open/floor/pod,/area/shuttle/escape)
"n" = (/turf/closed/wall/mineral/plastitanium,/area/shuttle/escape/engine)
"o" = (/obj/structure/table,/obj/machinery/recharger,/turf/open/floor/mineral/titanium/blue,/area/shuttle/escape)
"p" = (/obj/effect/mapping_helpers/airlock/access/all/engineering,/obj/machinery/door/airlock/engineering/glass,/turf/open/floor/plating,/area/shuttle/escape/engine)
"q" = (/obj/machinery/door/airlock/medical/glass{name = "Escape Shuttle Infirmary"},/turf/open/floor/mineral/titanium/white,/area/shuttle/escape)
"r" = (/turf/closed/wall/mineral/plastitanium,/area/space)
"s" = (/turf/open/floor/engine/air,/area/shuttle/escape/engine)
"t" = (/turf/open/space/basic,/area/space)
"u" = (/obj/structure/tramwall/plastitanium,/turf/open/floor/plating,/area/shuttle/escape/engine)
"v" = (/obj/effect/mapping_helpers/airlock/access/all/security/general,/obj/machinery/door/airlock/security/glass{name = "Escape Shuttle Brig"},/turf/open/floor/plating,/area/shuttle/escape)
"w" = (/obj/structure/table,/turf/open/floor/mineral/titanium/blue,/area/shuttle/escape)
"x" = (/obj/effect/spawner/structure/window/reinforced/shuttle,/turf/open/space/basic,/area/shuttle/escape)
"y" = (/obj/machinery/computer/emergency_shuttle,/turf/open/floor/mineral/titanium/blue,/area/shuttle/escape)
"z" = (/turf/open/floor/pod,/area/shuttle/escape)
"A" = (/obj/machinery/vending/wallmed/directional/west,/turf/open/floor/mineral/titanium/yellow,/area/shuttle/escape/engine)
"B" = (/obj/structure/reagent_dispensers/fueltank,/turf/open/floor/mineral/titanium/yellow,/area/shuttle/escape/engine)
"D" = (/obj/machinery/computer/communications,/turf/open/floor/mineral/titanium/blue,/area/shuttle/escape)
"E" = (/obj/structure/chair/stool/directional/west,/turf/open/floor/pod,/area/shuttle/escape)
"F" = (/obj/structure/extinguisher_cabinet/directional/north,/turf/open/floor/mineral/titanium/yellow,/area/shuttle/escape/engine)
"G" = (/obj/effect/spawner/structure/window/reinforced/shuttle,/obj/machinery/power/shuttle_engine/heater,/turf/open/floor/mineral/titanium/yellow,/area/shuttle/escape/engine)
"H" = (/obj/structure/sign/warning/fire/directional/north,/obj/structure/closet/firecloset/full,/turf/open/floor/mineral/titanium/yellow,/area/shuttle/escape/engine)
"I" = (/obj/structure/table,/obj/machinery/vending/wallmed/directional/west,/turf/open/floor/mineral/plastitanium/red/brig,/area/space)
"J" = (/turf/open/floor/mineral/plastitanium/red/brig,/area/space)
"L" = (/turf/open/floor/mineral/titanium/yellow,/area/shuttle/escape/engine)
"M" = (/obj/structure/chair/comfy/shuttle,/turf/open/floor/mineral/plastitanium/red/brig,/area/space)
"N" = (/obj/machinery/door/airlock/engineering/glass,/obj/effect/mapping_helpers/airlock/access/all/engineering,/turf/open/floor/plating,/area/shuttle/escape/engine)
"O" = (/turf/open/floor/mineral/titanium/blue,/area/shuttle/escape)
"P" = (/obj/machinery/vending/wallmed/directional/south{use_power = 0},/obj/structure/table,/turf/open/floor/mineral/titanium/white,/area/space)
"Q" = (/turf/open/floor/mineral/titanium/white,/area/space)
"R" = (/turf/open/floor/pod/light,/area/shuttle/escape)
"S" = (/obj/structure/chair/stool/directional/east,/turf/open/floor/pod,/area/shuttle/escape)
"T" = (/obj/structure/chair/comfy/shuttle{dir = 1},/turf/open/floor/mineral/plastitanium/red/brig,/area/space)
"U" = (/obj/effect/spawner/structure/window/reinforced/shuttle,/obj/effect/spawner/structure/window/reinforced/shuttle,/turf/open/floor/plating,/area/shuttle/escape/engine)
"V" = (/obj/machinery/door/airlock/shuttle,/obj/docking_port/mobile/emergency/shuttle_build{height = 15; name = "Welding Fuel Shuttle"; width = 30},/turf/open/floor/plating,/area/shuttle/escape)
"W" = (/obj/machinery/vending/wallmed/directional/south{use_power = 0},/turf/open/floor/pod,/area/shuttle/escape)
"X" = (/turf/closed/wall/mineral/plastitanium,/area/shuttle/escape)
"Y" = (/obj/structure/table,/obj/machinery/recharger,/obj/structure/table,/turf/open/floor/mineral/titanium/blue,/area/shuttle/escape)
"Z" = (/obj/structure/table,/turf/open/floor/mineral/titanium/white,/area/space)

(1,1,1) = {"
aXkkkkkXatttttt
akwywDwkatttttt
akOOOOOkatttttt
XXOOOOOXXtttttt
XYOOOOOoXtttttt
XwOOOOOwXtttttt
XXXmXmXXXrrrrrt
kzRRRRREXQQQQrr
XSRzzzRzkQQQQQr
gzREXSRzqQQQQQc
XSREXSRzqQQQQQc
VzREXSRExQQQQQr
XSREXSRzXeZZPrr
kzREXSRzXrrrrrt
kzRzWzRzXbMMMrr
kzREXSRzkJJJJJr
XSREXSREiJJJJJc
gzREXSRzvJJJJJc
XSREXSRzkJJJJJr
gzREXSRzXITTTrr
XSRzzzREXrrrrrt
kSzzzzzEXtttttt
nnnNnpnnntttttt
nHFLLLFBntttttt
ULLsssLLftttttt
fLLsjsLLftttttt
nBLsssLlntttttt
nnALLLBnntttttt
anGGGGGnatttttt
auddddduatttttt
"}
