//MAP CONVERTED BY dmm2tgm.py THIS HEADER COMMENT PREVENTS RECONVERSION, DO NOT REMOVE
"a" = (
/turf/template_noop,
/area/template_noop)
"c" = (
/turf/closed/wall/mineral/titanium/nodiagonal,
/area/shuttle/escape)
"e" = (
/turf/closed/wall/mineral/plastitanium,
/area/shuttle/escape)
"i" = (
/turf/open/floor/pod,
/area/shuttle/escape)
"j" = (
/obj/machinery/door/airlock/titanium{
	name = "Emergency Shuttle Airlock"
	},
/obj/docking_port/mobile/emergency{
	port_direction = 4;
	preferred_direction = 2;
	name = "Kerfuffle-Shuttle"
	},
/turf/open/floor/plating,
/area/shuttle/escape)
"n" = (
/turf/open/floor/iron/white,
/area/shuttle/escape)
"w" = (
/turf/open/floor/iron/dark,
/area/shuttle/escape)
"A" = (
/obj/structure/window/reinforced/spawner/directional/south,
/obj/machinery/power/shuttle_engine/heater{
	dir = 1
	},
/obj/effect/turf_decal/stripes/line{
	dir = 1
	},
/turf/open/floor/plating/airless,
/area/shuttle/escape)
"B" = (
/obj/machinery/power/shuttle_engine/propulsion{
	dir = 1
	},
/obj/effect/turf_decal/stripes/line{
	dir = 1
	},
/turf/open/floor/plating/airless,
/area/shuttle/escape)
"H" = (
/obj/modular_map_root/modular_shuttle,
/turf/open/floor/plating,
/area/shuttle/escape)
"I" = (
/turf/open/floor/plating,
/area/shuttle/escape)
"J" = (
/turf/open/space/basic,
/area/shuttle/escape)
"K" = (
/obj/modular_map_root/modular_shuttle/bridge,
/turf/open/space/basic,
/area/shuttle/escape)
"M" = (
/turf/open/floor/pod/light,
/area/shuttle/escape)
"W" = (
/turf/open/space/basic,
/area/template_noop)
"X" = (
/obj/machinery/door/airlock/titanium{
	name = "Emergency Shuttle Airlock"
	},
/turf/open/floor/plating,
/area/shuttle/escape)

(1,1,1) = {"
a
J
J
J
J
J
J
J
J
J
X
c
j
J
J
J
J
J
J
J
J
J
a
a
a
a
a
a
"}
(2,1,1) = {"
B
A
I
I
I
I
I
I
I
I
w
w
w
I
I
I
I
I
I
I
I
J
a
a
a
a
a
a
"}
(3,1,1) = {"
B
A
I
I
I
I
I
I
I
I
w
w
w
I
I
I
I
I
I
I
I
J
a
a
a
a
a
a
"}
(4,1,1) = {"
e
e
I
I
I
I
I
I
I
I
w
w
w
I
I
I
I
I
I
I
I
J
J
J
J
J
J
J
"}
(5,1,1) = {"
B
A
H
I
I
I
I
I
I
I
w
w
w
H
I
I
I
I
I
I
I
J
J
J
J
J
J
J
"}
(6,1,1) = {"
B
A
I
I
I
I
I
I
I
I
w
w
w
I
I
I
I
I
I
I
I
J
J
J
J
J
J
J
"}
(7,1,1) = {"
B
A
I
I
I
I
I
I
I
I
w
M
w
I
I
I
I
I
I
I
I
J
J
J
J
J
J
J
"}
(8,1,1) = {"
e
e
I
I
I
I
I
I
I
I
i
i
i
I
I
I
I
I
I
I
I
J
J
J
J
J
J
J
"}
(9,1,1) = {"
B
A
n
n
n
n
n
n
n
M
i
M
i
M
n
n
n
n
n
n
n
K
J
J
J
J
J
J
"}
(10,1,1) = {"
e
e
I
I
I
I
I
I
I
I
i
i
i
I
I
I
I
I
I
I
I
J
J
J
J
J
J
J
"}
(11,1,1) = {"
B
A
I
I
I
I
I
I
I
I
w
M
w
I
I
I
I
I
I
I
I
J
J
J
J
J
J
J
"}
(12,1,1) = {"
B
A
I
I
I
I
I
I
I
I
w
w
w
I
I
I
I
I
I
I
I
J
J
J
J
J
J
J
"}
(13,1,1) = {"
B
A
I
I
I
I
I
I
I
I
w
w
w
I
I
I
I
I
I
I
I
J
J
J
J
J
J
J
"}
(14,1,1) = {"
e
e
H
I
I
I
I
I
I
I
w
w
w
H
I
I
I
I
I
I
I
J
J
J
J
J
J
J
"}
(15,1,1) = {"
B
A
I
I
I
I
I
I
I
I
w
w
w
I
I
I
I
I
I
I
I
J
W
W
W
W
W
W
"}
(16,1,1) = {"
B
A
I
I
I
I
I
I
I
I
w
w
w
I
I
I
I
I
I
I
I
J
a
a
a
a
a
a
"}
(17,1,1) = {"
a
J
J
J
J
J
J
J
J
J
X
c
X
J
J
J
J
J
J
J
J
J
a
a
a
a
a
a
"}
