//MAP CONVERTED BY dmm2tgm.py THIS HEADER COMMENT PREVENTS RECONVERSION, DO NOT REMOVE
"a" = (
/turf/open/indestructible/dark,
/area/virtual_domain/fullbright)
"d" = (
/obj/effect/baseturf_helper/virtual_domain,
/obj/modular_map_root/safehouse{
	key = "wood"
	},
/turf/template_noop,
/area/virtual_domain/safehouse)
"f" = (
/obj/structure/rack,
/turf/open/indestructible/dark,
/area/virtual_domain/fullbright)
"l" = (
/obj/structure/reagent_dispensers/fueltank,
/turf/open/indestructible/dark,
/area/virtual_domain/fullbright)
"p" = (
/obj/structure/reagent_dispensers/fueltank/large,
/turf/open/indestructible/dark,
/area/virtual_domain/fullbright)
"r" = (
/turf/template_noop,
/area/virtual_domain/safehouse)
"t" = (
/obj/structure/rack,
/obj/item/gun/ballistic/revolver,
/obj/item/gun/ballistic/revolver{
	pixel_x = 1;
	pixel_y = 5
	},
/turf/open/indestructible/dark,
/area/virtual_domain/fullbright)
"v" = (
/turf/closed/indestructible/binary,
/area/virtual_domain/fullbright)
"x" = (
/turf/open/indestructible/plating,
/area/virtual_domain/fullbright)
"z" = (
/obj/structure/rack,
/obj/item/gun/ballistic/revolver,
/turf/open/indestructible/plating,
/area/virtual_domain/fullbright)
"A" = (
/turf/open/indestructible/hierophant,
/area/virtual_domain/fullbright)
"E" = (
/obj/effect/baseturf_helper/virtual_domain,
/turf/closed/indestructible/binary,
/area/virtual_domain/fullbright)
"J" = (
/obj/structure/rack,
/obj/item/reagent_containers/hypospray/combat/nanites,
/obj/item/reagent_containers/hypospray/combat/nanites,
/turf/open/indestructible/plating,
/area/virtual_domain/fullbright)
"K" = (
/obj/structure/reagent_dispensers/fueltank,
/obj/structure/reagent_dispensers/fueltank,
/turf/open/indestructible/dark,
/area/virtual_domain/fullbright)
"P" = (
/turf/open/indestructible/hierophant/two,
/area/virtual_domain/fullbright)
"R" = (
/obj/structure/rack,
/obj/item/gun/ballistic/revolver,
/turf/open/indestructible/dark,
/area/virtual_domain/fullbright)
"T" = (
/obj/structure/rack,
/turf/open/indestructible/plating,
/area/virtual_domain/fullbright)
"X" = (
/turf/closed/wall/mineral/wood,
/area/virtual_domain/fullbright)
"Y" = (
/obj/structure/rack,
/obj/item/reagent_containers/hypospray/combat/nanites,
/turf/open/indestructible/plating,
/area/virtual_domain/fullbright)

(1,1,1) = {"
v
v
v
v
v
v
v
v
v
v
v
v
v
v
v
v
v
v
v
v
v
v
v
v
E
"}
(2,1,1) = {"
v
a
a
a
a
a
a
a
a
a
a
a
a
a
a
a
a
a
a
a
a
a
a
a
v
"}
(3,1,1) = {"
v
a
r
r
r
r
r
d
a
a
a
a
a
a
a
a
a
a
a
a
a
a
a
a
v
"}
(4,1,1) = {"
v
a
r
r
r
r
r
r
a
a
a
a
a
a
a
a
a
a
a
a
a
a
a
a
v
"}
(5,1,1) = {"
v
a
r
r
r
r
r
r
a
a
a
a
a
a
a
a
a
a
a
a
a
a
a
a
v
"}
(6,1,1) = {"
v
a
r
r
r
r
r
r
a
a
a
a
a
a
a
a
a
a
a
a
a
a
a
a
v
"}
(7,1,1) = {"
v
a
r
r
r
r
r
r
a
a
a
a
a
a
a
a
a
a
a
a
a
a
a
a
v
"}
(8,1,1) = {"
v
a
r
r
r
r
r
r
a
a
a
a
a
a
a
a
a
a
a
a
a
a
a
a
v
"}
(9,1,1) = {"
v
a
r
r
r
r
r
r
a
a
a
a
a
a
a
a
a
a
a
a
a
a
a
a
v
"}
(10,1,1) = {"
v
a
a
a
a
a
a
a
a
a
a
a
a
a
a
a
a
a
a
a
a
a
a
a
v
"}
(11,1,1) = {"
v
a
a
a
a
a
a
P
A
a
a
a
a
a
a
a
a
a
a
a
a
a
a
a
v
"}
(12,1,1) = {"
v
v
v
v
v
a
a
A
P
a
a
a
a
a
a
a
a
a
a
a
a
a
a
a
v
"}
(13,1,1) = {"
v
p
a
a
v
a
a
P
A
a
a
a
a
a
a
a
a
a
a
a
a
a
a
a
v
"}
(14,1,1) = {"
v
p
a
a
X
a
a
A
P
a
a
a
a
a
a
a
a
a
a
a
a
a
a
a
v
"}
(15,1,1) = {"
v
a
a
a
X
a
a
P
A
a
a
a
a
a
a
a
a
a
a
a
a
a
a
a
v
"}
(16,1,1) = {"
v
a
a
a
v
a
a
A
P
a
a
a
a
a
a
a
a
a
a
a
a
a
a
a
v
"}
(17,1,1) = {"
v
v
v
v
v
a
a
P
A
P
A
P
A
P
A
P
A
P
A
P
A
a
a
a
v
"}
(18,1,1) = {"
v
l
K
l
a
a
a
A
P
A
P
A
P
A
P
A
P
A
P
A
P
a
a
a
v
"}
(19,1,1) = {"
v
a
a
l
a
x
x
x
x
x
x
a
a
a
a
a
a
a
a
a
a
a
a
a
v
"}
(20,1,1) = {"
v
l
a
a
a
x
Y
x
x
z
x
a
a
a
a
a
a
a
a
a
a
a
a
a
v
"}
(21,1,1) = {"
v
l
a
a
a
x
f
x
x
T
x
a
a
a
a
a
a
a
a
a
a
a
a
a
v
"}
(22,1,1) = {"
v
l
a
l
a
x
R
x
x
Y
x
a
a
a
a
a
a
a
a
a
a
a
a
a
v
"}
(23,1,1) = {"
v
l
l
l
a
x
t
x
x
J
x
a
a
a
a
a
a
a
a
a
a
a
a
a
v
"}
(24,1,1) = {"
v
l
l
a
a
x
x
x
x
x
x
a
a
a
a
a
a
a
a
a
a
a
a
a
v
"}
(25,1,1) = {"
v
v
v
v
v
v
v
v
v
v
v
v
v
v
v
v
v
v
v
v
v
v
v
v
v
"}
